*
00000000
00000000
00000000
00011000
01011010
00111100
01111110
00111100
01011010
00011000
00000000
00000000
00000000
00000000
00000000
00000000