*
00000000
00000000
01111110
11111111
11111111
11111111
11111111
11111111
11111111
01111110
00000000
00000000
00000000
00000000
00000000
00000000