@
00000000
00000000
00000000
00111100
01100110
11000011
10000001
10001101
10010011
10010001
10010001
10010011
11001101
01100000
00110000
00011110