\
00000000
00000000
00000000
01000000
01000000
00100000
00100000
00010000
00010000
00001000
00001000
00000100
00000100
00000010
00000010
00000000