\
00000000
00000000
10000000
11000000
11000000
11100000
11100000
11110000
11110000
11111000
11111000
01111100
01111100
00111110
00011110
00011111