^
00000000
00000000
00011000
00111100
01111110
11111111
11111111
11100111
11000011
10000001
00000000
00000000
00000000
00000000
00000000
00000000