#
00000000
00000000
00000000
00010010
00010010
00100100
01111111
00100100
00100100
00100100
11111110
00100100
01001000
01001000
00000000
00000000