(
00000000
00000111
00011111
00011111
00111100
00111000
00111000
00111000
00111000
00111000
00111000
00111100
00011111
00011111
00000111
00000000