[
00000000
00000000
00011110
00011110
00011000
00011000
00011000
00011000
00011000
00011000
00011000
00011000
00011110
00011110
00000000
00000000