<
00000000
00000000
00000000
00000000
00000010
00001100
00110000
11000000
11000000
00110000
00001100
00000010
00000000
00000000
00000000
00000000