(
00000000
00000100
00011000
00011000
00110000
00110000
00110000
00100000
00100000
00110000
00110000
00110000
00011000
00011000
00000100
00000000