<
00000000
00000000
00000000
00000000
00000011
00001111
00111110
11111000
11111000
00111110
00001111
00000011
00000000
00000000
00000000
00000000