V
00000000
00000000
00000000
00000000
00000000
00000000
00000000
11000011
11000011
11100111
11100111
11111111
11111111
01111110
00111100
00011000