v
00000000
00000000
00000000
00000000
00000000
00000000
01000010
01000010
01000010
00100100
00100100
00111100
00011000
00000000
00000000
00000000