>
00000000
00000000
00000000
00000000
11000000
11110000
01111100
00011111
00011111
01111100
11110000
11000000
00000000
00000000
00000000
00000000