)
00000000
00100000
00011000
00011000
00001100
00001100
00001100
00000100
00000100
00001100
00001100
00001100
00011000
00011000
00100000
00000000