)
00000000
11100000
11111000
11111000
00111100
00011100
00011100
00011100
00011100
00011100
00011100
00111100
11111000
11111000
11100000
00000000