>
00000000
00000000
00000000
00000000
01000000
00110000
00001100
00000011
00000011
00001100
00110000
01000000
00000000
00000000
00000000
00000000