]
00000000
00000000
01111000
01111000
00011000
00011000
00011000
00011000
00011000
00011000
00011000
00011000
01111000
01111000
00000000
00000000