;
00000000
00000000
00000000
00000000
00000000
00000000
00000000
00000000
00011000
00011000
00000000
00011000
00011000
00110000
00100000
00000000