/
00000000
00000000
00000001
00000011
00000011
00000111
00000111
00001111
00001111
00011111
00011111
00111110
00111110
01111100
01111000
11111000