~
00000000
00000000
00000000
00000000
00000000
00000000
00000000
01110001
10001110
00000000
00000000
00000000
00000000
00000000
00000000
00000000